10
8
110s000000
v101111100
1000000111
1000010001
11011v1101
0r00100101
0111110111
00000j0000