000000000000000000000111111000000000000000000000
011111111111111111111111111111111111111111111110
011111111111111111111111111111111111111111111110
011111111111111111111111111111111111111111111110
011111111111111111111111111111111111111111111110
011111111111111111111111111111111111111111111110
011111111111111111111111111111111111111111111110
011111111111111111111111111111111111111111111110
011111111111111111111111111111111111111111111110
011111111111111111111111111111111111111111111110
011111111111111111111111111111111111111111111110
011111111111000000000000000000000000111111111110
011111111111111111111111111111111111111111111110
011111111111111111111111111111111111111111111110
011111111111111111111111111111111111111111111110
011111111111111111111111111111111111111111111110
011111111111111111111111111111111111111111111110
01111111111111111111s111111111111111111111111110
011111111111111111111111111111111111111111111110
011111111111111111111111111111111111111111111110
011111111111111111111111111111111111111111111110
011111111111111111111111111111111111111111111110
011111111111111111111111111111111111111111111110
011111111111000000000000000000000000111111111110
011111111111111111111111111111111111111111111110
011111111111111111111111111111111111111111111110
011111111111111111111111111111111111111111111110
011111111111111111111111111111111111111111111110
011111111111111111111111111111111111111111111110
011111111111111111111111111111111111111111111110
011111111111111111111111111111111111111111111110
011111111111111111111111111111111111111111111110
011111111111111111111111111111111111111111111110
011111111111111111111111111111111111111111111110
011111111111111111111111111111111111111111111110
000000000000000000000111111000000000000000000000