000000000000000000000011110000000000000000000000
011111111111111111111111111111111111111111111110
011111111111111111111111111111111111111111111110
011111111111111111111111111111111111111111111110
011111111111111111111111111111111111111111111110
011111111111111111111111111111111111111111111110
011111111111111111111111111111111111111111111110
011111111111111111111111111111111111111111111110
011111111111111111111111111111111111111111111110
011111111111111111111111111111111111111111111110
011111111111111111111111111111111111111111111110
011111111111111111111111111111111111111111111110
011111111111111111111111111111111111111111111110
011111111111111111111111111111111111111111111110
011111111111111111111111111111111111111111111110
011111111111111111111111111111111111111111111110
111111111111111111111111111111111111111111111111
111111111111111111111111111111111111111111111111
11111111111111111111s111111111111111111111111111
111111111111111111111111111111111111111111111111
011111111111111111111111111111111111111111111110
011111111111111111111111111111111111111111111110
011111111111111111111111111111111111111111111110
011111111111111111111111111111111111111111111110
011111111111111111111111111111111111111111111110
011111111111111111111111111111111111111111111110
011111111111111111111111111111111111111111111110
011111111111111111111111111111111111111111111110
011111111111111111111111111111111111111111111110
011111111111111111111111111111111111111111111110
011111111111111111111111111111111111111111111110
011111111111111111111111111111111111111111111110
011111111111111111111111111111111111111111111110
011111111111111111111111111111111111111111111110
011111111111111111111111111111111111111111111110
000000000000000000000011110000000000000000000000